1502386986 0 1 0 0 0 0 0 0 0
1502387090 1 1 0 0 0 0 0 0 0
1502387728 2 1 0 0 0 0 0 0 0
1502442589 3 1 0 0 0 0 0 0 0
1502525927 4 1 0 0 0 0 0 0 0
1502526021 5 1 0 0 0 0 0 0 0
1502526472 6 1 0 0 0 0 0 0 0
1502526491 7 1 0 0 0 0 0 0 0
1502526699 8 1 0 0 0 0 0 0 0
1502557102 9 1 0 0 0 0 0 0 0
1502627176 10 1 0 0 0 0 0 0 0
1502645664 11 1 0 0 0 0 0 0 0
1502645698 12 1 0 0 0 0 0 0 0
1503247562 13 1 0 0 0 0 0 0 0
1503247625 14 1 0 0 0 0 0 0 0
1503247665 15 1 0 0 0 0 0 0 0
1503249660 16 1 0 0 0 0 0 0 0
1503249679 17 1 0 0 0 0 0 0 0
1503250067 18 1 0 0 0 0 0 0 0
1503309166 19 1 0 0 0 0 0 0 0
1504557803 20 1 0 0 0 0 0 0 0
1504629541 21 1 0 0 0 0 0 0 0
1504629640 22 1 0 0 0 0 0 0 0
1505035343 23 1 0 0 0 0 0 0 0
1505035435 24 1 0 0 0 0 0 0 0
1505149260 25 1 0 0 0 0 0 0 0
1505151493 26 1 0 0 0 0 0 0 0
1506626412 27 1 0 0 0 0 0 0 0
1506778763 28 1 0 0 0 0 0 0 0
1506857585 29 1 0 0 0 0 0 0 0
1506880995 30 1 0 0 0 0 0 0 0
1506966611 31 1 0 0 0 0 0 0 0
1513017885 31 2 0 0 0 0 0 0 0
1528744303 31 3 0 0 0 0 0 0 0
1528744438 32 3 0 0 0 0 0 0 0
1528920411 32 3 0 0 0 0 0 0 1
1536780169 32 4 0 0 0 0 0 0 1
1536862323 33 4 0 0 0 0 0 0 1
1537119123 34 4 0 0 0 0 0 0 1
1537119127 35 4 0 0 0 0 0 0 1
1537120525 36 4 0 0 0 0 0 0 1
1537121412 37 4 0 0 0 0 0 0 1
1537121872 38 4 0 0 0 0 0 0 1
1537121926 39 4 0 0 0 0 0 0 1
1537122525 40 4 0 0 0 0 0 0 1
1537214201 41 4 0 0 0 0 0 0 1
1537215499 42 4 0 0 0 0 0 0 1
1537218433 42 4 0 1 0 0 0 0 1
1537515590 42 4 0 2 0 0 0 0 1
1540726686 43 4 0 2 0 0 0 0 1
1540726757 44 4 0 2 0 0 0 0 1
1540731188 45 4 0 2 0 0 0 0 1
1547394810 46 4 0 2 0 0 0 0 1
1547407351 47 4 0 2 0 0 0 0 1
1547409087 48 4 0 2 0 0 0 0 1
1547413553 49 4 0 2 0 0 0 0 1
1547497713 50 4 0 2 0 0 0 0 1
1547497766 51 4 0 2 0 0 0 0 1
1547577463 52 4 0 2 0 0 0 0 1
1547988423 53 4 0 2 0 0 0 0 1
1547988456 54 4 0 2 0 0 0 0 1
1548504014 55 4 0 2 0 0 0 0 1
1548504125 56 4 0 2 0 0 0 0 1
1548505343 57 4 0 2 0 0 0 0 1
1548505401 58 4 0 2 0 0 0 0 1
1550004931 58 5 0 2 0 0 0 0 1
1550005215 59 5 0 2 0 0 0 0 1
1550084499 60 5 0 2 0 0 0 0 1
1550431431 60 6 0 2 0 0 0 0 1
1551129387 60 7 0 2 0 0 0 0 1
1556469329 60 8 0 2 0 0 0 0 1
1556972397 60 9 0 2 0 0 0 0 1
1557697009 60 9 0 2 0 1 0 0 1
1558175289 61 9 0 2 0 1 0 0 1
1558175332 62 9 0 2 0 1 0 0 1
1558176605 63 9 0 2 0 1 0 0 1
1562773346 63 9 0 2 1 1 0 0 1
1565901016 64 9 0 2 1 1 0 0 1
1565901090 65 9 0 2 1 1 0 0 1
1566494698 66 9 0 2 1 1 0 0 1
1569436046 67 9 0 2 1 1 0 0 1
1569440819 68 9 0 2 1 1 0 0 1
1569441298 69 9 0 2 1 1 0 0 1
1569441742 70 9 0 2 1 1 0 0 1
1569442801 70 9 0 2 2 1 0 0 1
1572026275 71 9 0 2 2 1 0 0 1
1585429336 72 9 0 2 2 1 0 0 1
1585429633 73 9 0 2 2 1 0 0 1
1585600062 74 9 0 2 2 1 0 0 1
1586611111 75 9 0 2 2 1 0 0 1
1586614995 76 9 0 2 2 1 0 0 1
1586780769 77 9 0 2 2 1 0 0 1
1587149376 78 9 0 2 2 1 0 0 1
1589713400 79 9 0 2 2 1 0 0 1
1589714373 80 9 0 2 2 1 0 0 1
1589718841 81 9 0 2 2 1 0 0 1
1592802209 82 9 0 2 2 1 0 0 1
1596995129 83 9 0 2 2 1 0 0 1
1598209731 83 9 0 2 2 1 1 0 1
1604846757 84 9 0 2 2 1 1 0 1
1613240723 84 9 0 2 2 1 1 1 1
1645977373 85 9 0 2 2 1 1 1 1
1645981095 86 9 0 2 2 1 1 1 1
1645981372 87 9 0 2 2 1 1 1 1
1646075430 88 9 0 2 2 1 1 1 1
1646075876 89 9 0 2 2 1 1 1 1
1648129780 90 9 0 2 2 1 1 1 1
1648129795 91 9 0 2 2 1 1 1 1
1648130410 92 9 0 2 2 1 1 1 1
1648131040 92 9 1 2 2 1 1 1 1
1648155026 93 9 1 2 2 1 1 1 1
1648218102 93 9 2 2 2 1 1 1 1
1649004647 94 9 2 2 2 1 1 1 1
1649181266 94 9 3 2 2 1 1 1 1
1650218587 95 9 3 2 2 1 1 1 1
1650220310 96 9 3 2 2 1 1 1 1
1651308471 97 9 3 2 2 1 1 1 1
1651308513 98 9 3 2 2 1 1 1 1
1652826102 98 9 4 2 2 1 1 1 1
1653156875 99 9 4 2 2 1 1 1 1
1653158389 100 9 4 2 2 1 1 1 1
1653158613 101 9 4 2 2 1 1 1 1
1655147019 102 9 4 2 2 1 1 1 1
1671386989 103 9 4 2 2 1 1 1 1
1671387451 103 9 5 2 2 1 1 1 1
1671387481 103 9 6 2 2 1 1 1 1
1672335774 104 9 6 2 2 1 1 1 1
1672960062 105 9 6 2 2 1 1 1 1
1680276912 106 9 6 2 2 1 1 1 1
